035
Гебрейесус	Гебрейесус	PER	PER-Tedros-Adhanom-Ghebreyesus
Доналд Тръмп	Доналд Тръмп	PER	PER-Donald-Trump
Китай	Китай	LOC	GPE-China
Комитетът за спешни случаи	Комитет за спешни случаи	ORG	ORG-Emergency-Committee-WHO
Комунистическа партия	Комунистическа партия	ORG	GPE-Communist-Party-of-China
Майк Помпео	Майк Помпео	PER	PER-Mike-Pompeo
ООН	ООН	ORG	ORG-United-Nations
САЩ	САЩ	LOC	GPE-USA
СЗО	СЗО	ORG	ORG-WHO
Световната здравна организация (СЗО)	Световна здравна организация (СЗО)	ORG	ORG-WHO
Тедрос Аданом Гебрейес	Тедрос Аданом Гебрейес	PER	PER-Tedros-Adhanom-Ghebreyesus
Тедрос	Тедрос	PER	PER-Tedros-Adhanom-Ghebreyesus
Тръмп	Тръмп	PER	PER-Donald-Trump
епидемията от новия коронавирус	епидемия от новия коронавирус	EVT	EVT-Covid-19
извънредно положение	извънредно положение	EVT	EVT-State-of-Emergency
извънредното положение	извънредно положение	EVT	EVT-State-of-Emergency
коронавирус	коронавирус	EVT	EVT-Covid-19
коронавируса	коронавирус	EVT	EVT-Covid-19
пандемията от COVID-19	пандемия от COVID-19	EVT	EVT-Covid-19
пандемията	пандемия	EVT	EVT-Pandemic
централата на СЗО в Женева	централа на СЗО в Женева	LOC	LOC-The-WHO-Headquarters-in-Geneva
