sl-175
Ali ima kapitalizem prihodnost?	Ali ima kapitalizem prihodnost?	PRO	PRO-Does-Capitalism-Have-a-Future?
Amazon	Amazon	ORG	ORG-Amazon
David Brooks	David Brooks	PER	PER-David-Brooks
Facebook	Facebook	PRO	PRO-Facebook
Google	Google	ORG	ORG-Google
Harari	Harari	PER	PER-Yuval-Noah-Harari
Harariju	Harari	PER	PER-Yuval-Noah-Harari
Homodeus	Homodeus	PRO	PRO-Homodeus
Immanuel Wallerstein	Immanuel Wallerstein	PER	PER-Immanuel-Wallerstein
Kitajski	Kitajska	LOC	GPE-China
Liquid modernity	Liquid modernity	PRO	PRO-Liquid-Modernity
Maslowova hierarhija	Maslowova hierarhija	PRO	PRO-Maslow's-hierarchy-of-needs
Maslowu	Maslow	PER	PER-Abraham-Maslow
New York Times	New York Times	PRO	PRO-The-New-York-Times
Pandorino skrinjico	Pandorina skrinjica	PRO	PRO-Pandora-Box
Yuval Noah Harari	Yuval Noah Harari	PER	PER-Yuval-Noah-Harari
Zygmunt Bauman	Zygmunt Bauman	PER	PER-Zygmunt-Bauman
covid-19	covid-19	EVT	EVT-Covid-19
covid	covid	EVT	EVT-Covid-19
covida-19	covid-19	EVT	EVT-Covid-19
epidemije covida-19	epidemija covida-19	EVT	EVT-Covid-19
