sl-108
Alex Azar	Alex Azar	PER	PER-Alex-Azar
Izraelu	Izrael	LOC	GPE-Israel
Logarjeva	Logar	PER	PER-Mateja-Logar
Mateje Logar	Mateja Logar	PER	PER-Mateja-Logar
Mihail Muraško	Mihail Muraško	PER	PER-Mikhail-Murashko
Moskvo	Moskva	LOC	GPE-Moscow
Muraško	Muraško	PER	PER-Mikhail-Murashko
Nemčiji	Nemčija	LOC	GPE-Germany
Rusija	Rusija	LOC	GPE-Russia
Rusije	Rusija	LOC	GPE-Russia
Sloveniji	Slovenija	LOC	GPE-Slovenia
Svetovna zdravstvena organizacija	Svetovna zdravstvena organizacija	ORG	ORG-World-Health-Organization
Svetovne zdravstvene organizacije	Svetovna zdravstvena organizacija	ORG	ORG-World-Health-Organization
Tass	Tass	ORG	ORG-TASS-Agency
WHO	WHO	ORG	ORG-World-Health-Organization
ZDA	ZDA	LOC	GPE-USA
covid-19	covid-19	EVT	EVT-Covid-19
covida-19	covid-19	EVT	EVT-Covid-19
inštitut Gamaleja	inštitut Gamaleja	ORG	ORG-Gamaleya-Research-Institute-of-Epidemiology-and-Microbiology
inštituta Gamaleja	inštitut Gamaleja	ORG	ORG-Gamaleya-Research-Institute-of-Epidemiology-and-Microbiology
koroanvirusu	koronavirus	EVT	EVT-Covid-19
