sl-2
AFP	AFP	ORG	ORG-AFP-Agence-France-Press
Charite	Charite	LOC	LOC-Charite-University-Hospital-Berlin
Christiana Drostena	Christian Drosten	PER	PER-Christian-Drosten
Clemensa Wendtnerja	Clemens Wendtner	PER	PER-Clemens-Wendtner
EMA	EMA	ORG	ORG-EMA-European-Medicines-Agency
Evropska agencija za zdravila	Evropska agencija za zdravila	ORG	ORG-EMA-European-Medicines-Agency
Evropske unije	evropska unija	ORG	ORG-European-Union
M체nchna	M체nchen	LOC	GPE-Munich
Nature	Nature	PRO	PRO-Nature-(journal)
Nem훾iji	Nem훾ija	LOC	GPE-Germany
Novi koronavirus	Novi koronavirus	EVT	EVT-Covid-19
Schwabing	Schwabing	LOC	LOC-Munchen-Klinik-Schwabing
covida-19	covid-19	EVT	EVT-Covid-19
covidom-19	covid-19	EVT	EVT-Covid-19
covidu-19	covid-19	EVT	EVT-Covid-19
dpa	dpa	ORG	ORG-DPA
koronavirusni bolezni 19	koronavirusna bolezen 19	EVT	EVT-Covid-19
novim koronavirusom	novi koronavirus	EVT	EVT-Covid-19
sars-cov-2	sars-cov-2	EVT	EVT-Covid-19
