sl-202
Covid-19	Covid-19	EVT	EVT-Covid-19
Hrvatih	Hrvati	PER	GPE-Croatia
Hrvaškem	Hrvaška	LOC	GPE-Croatia
Italijani	Italijani	PER	GPE-Italy
Italije	Italija	LOC	GPE-Italy
Italiji	Italija	LOC	GPE-Italy
Italijo	Italija	LOC	GPE-Italy
Janez Janša	Janez Janša	PER	PER-Janez-Janša
Kitajcem	Kitajci	PER	GPE-China
Kitajci	Kitajci	PER	GPE-China
Kitajska	Kitajska	LOC	GPE-China
Kitajske	Kitajska	LOC	GPE-China
Kitajski	Kitajska	LOC	GPE-China
Ljubljana	Ljubljana	LOC	GPE-Ljubljana
Matej Tonin	Matej Tonin	PER	PER-Matej-Tonin
Metliki	Metlika	LOC	GPE-Metlika
Ministrstvo za zdravje	Ministrstvo za zdravje	ORG	ORG-Ministry-of-Health-Slovenia
Rdeči križ	Rdeči križ	ORG	ORG-Red-Cross-Slovenia
Slovenci	Slovenci	PER	GPE-Slovenia
Slovenije	Slovenija	LOC	GPE-Slovenia
Sloveniji	Slovenija	LOC	GPE-Slovenia
Srečko Šestan	Srečko Šestan	PER	PER-Srečko-Šestan
Srečkom Šestanom	Srečko Šestan	PER	PER-Srečko-Šestan
Svet za nacionalno varnost	Svet za nacionalno varnost	ORG	ORG-National-Security-Council-Slovenia
koronavirusom	koronavirus	EVT	EVT-Covid-19
ministrstva za zdravje	ministrstvo za zdravje	ORG	ORG-Ministry-of-Health-Slovenia
novim koronavirusom	novi koronavirus	EVT	EVT-Covid-19
