sl-128
9103 Rakičan	9103 Rakičan	LOC	LOC-Post-Office-9103-Rakičan
3334 Luče	3334 Luče	LOC	LOC-Post-Office-3334-Luče
9201 Puconci	9201 Puconci	LOC	LOC-Post-Office-9201-Puconci
9263 Kuzma	9263 Kuzma	LOC	LOC-Post-Office-9263-Kuzma
COVID-19	COVID-19	EVT	EVT-Covid-19
COVIDA-19	COVID-19	EVT	EVT-Covid-19
Direct4.me	Direct4.me	PRO	PRO-Direct4.me
Društvo spletnih trgovcev	Društvo spletnih trgovcev	ORG	ORG-Društvo-spletnih-trgovcev
Kopru	Koper	LOC	GPE-Koper
Ljubljani	Ljubljana	LOC	GPE-Ljubljana
NIJZ	NIJZ	ORG	ORG-Slovenian-National-Institute-of-Public-Health
Nacionalnega inštituta za javno zdravje	Nacionalni inštitut za javno zdravje	ORG	ORG-Slovenian-National-Institute-of-Public-Health
Ostani zdrav	Ostani zdrav	PRO	PRO-mobile-application-#ostanizdrav
PS Paketomatov	PS Paketomati	PRO	PRO-Paketomat-Post-of-Slovenia
Pošta Slovenije	Pošta Slovenije	ORG	ORG-Post-of-Slovenia
Pošte Slovenije	Pošta Slovenije	ORG	ORG-Post-of-Slovenia
Sloveniji	Slovenija	LOC	GPE-Slovenia
Splošne bolnišnice Murska Sobota	Splošna bolnišnica Murska Sobota	LOC	ORG-General-Hospital-Murska-Sobota
Univerzitetnem kliničnem centru Ljubljana	Univerzitetni klinični center Ljubljana	LOC	LOC-University-Medical-Centre-Ljubljana
Univerzitetnem kliničnem centru Maribor	Univerzitetni klinični center Maribor	LOC	LOC-University-Medical-Center-Maribor
pošta 1114 Ljubljana	pošta 1114 Ljubljana	LOC	LOC-Post-Office-1114-Ljubljana
pošta 2114 Maribor	pošta 2114 Maribor	LOC	LOC-Post-Office-2114-Maribor
pošti 3335 Solčava	pošta 3335 Solčava	LOC	LOC-Post-Office-3335-Solčava
poštni logistični center Ljubljana	poštni logistični center Ljubljana	LOC	LOC-Logistični-center-Pošte-Slovenije-Ljubljana
poštni logistični center Maribor	poštni logistični center Maribor	LOC	LOC-Logistični-center-Pošte-Slovenije-Maribor
uprava v Mariboru	uprava v Mariboru	LOC	LOC-Uprava-Pošte-Slovenije-Maribor
