sl-111
Afp	Afp	ORG	ORG-AFP-Agence-France-Press
Američani	Američani	PER	GPE-USA
Angela Weiss	Angela Weiss	PER	PER-Angela-Weiss
Angele Merkel	Angele Merkel	PER	PER-Angela-Merkel
Ann	Ann	PER	PER-Ann
Bele hiše	Bela hiša	LOC	LOC-White-House
Belo hiši	Bela hiša	LOC	LOC-White-House
Belo hišo	Bela hiša	LOC	LOC-White-House
Biden	Biden	PER	PER-Joe-Biden
Bidna	Biden	PER	PER-Joe-Biden
Bidnove	Biden	PER	PER-Joe-Biden
Bidnu	Biden	PER	PER-Joe-Biden
Bližnjem vzhodu	Bližnji vzhod	LOC	LOC-Middle-East
Bogomil Ferfila	Bogomil Ferfila	PER	PER-Bogomil-Ferfila
Bojan Grobovšek	Bojan Grobovšek	PER	PER-Bojan-Grobovšek
Carlos Barria	Carlos Barria	PER	PER-Carlos-Barria
Delo	Delo	PRO	PRO-Delo
Donald Trump	Donald Trump	PER	PER-Donald-Trump
Donalda Trumpa	Donald Trump	PER	PER-Donald-Trump
Donaldu Trumpu	Donald Trump	PER	PER-Donald-Trump
EU	EU	ORG	ORG-European-Union
Ernest Petrič	Ernest Petrič	PER	PER-Ernest-Petrič
Janeza Janše	Janez Janša	PER	PER-Janez-Janša
Jim Bourg	Jim Bourg	PER	PER-Jim-Bourg
Joe Biden	Joe Biden	PER	PER-Joe-Biden
Joeja Bidna	Joe Biden	PER	PER-Joe-Biden
Joeju Bidenu	Joe Biden	PER	PER-Joe-Biden
Joeju Bidnu	Joe Biden	PER	PER-Joe-Biden
Kamale Harris	Kamala Harris	PER	PER-Kamala-Harris
Kitajsko	Kitajska	LOC	GPE-China
Kremlju	Kremelj	ORG	ORG-Kremlin
Leonid Slucki	Leonid Slucki	PER	PER-Leonid-Slucki
Luka Lisjak Gabrijelčič	Luka Lisjak Gabrijelčič	PER	PER-Luka-Lisjak-Gabrijelčič
Maruša Bradač	Maruša Bradač	PER	PER-Maruša-Bradač
Nemčiji	Nemčija	LOC	GPE-Germany
Pensilvanske avenije	Pensilvanska avenija	LOC	LOC-Pennsylvania-Avenue
Reuters	Reuters	ORG	ORG-Reuters
Roman Kirn	Roman Kirn	PER	PER-Roman-Kirn
Scrantonu	Scranton	LOC	GPE-Scranton
Sloveniji	Slovenija	LOC	GPE-Slovenia
Slovenijo	Slovenija	LOC	GPE-Slovenia
Slovenki	Slovenki	PER	GPE-Slovenia
Slovenskega društva za mednarodne odnose	Slovensko društvo za mednarodne odnose	ORG	ORG-Slovenian-Society-for-foreign-relations
Sophia	Sophia	PER	PER-Sophia
Tamil Nadu	Tamil Nadu	LOC	GPE-Tamil-Nadu
Trump	Trump	PER	PER-Donald-Trump
Trumpa	Trump	PER	PER-Donald-Trump
Tulasendrapurama	Tulasendrapuram	LOC	LOC-Tulasendrapuram
Urška Velikonja	Urška Velikonja	PER	PER-Urška-Velikonja
Washingtonu	Washington	LOC	GPE-WashingtonDC
ZDA	ZDA	LOC	GPE-USA
Zlatko Šabić	Zlatko Šabić	PER	PER-Zlatko-Šabić
demokrata	demokrat	PER	ORG-Democratic-Party-USA
drugi svetovni vojni	druga svetovna vojna	EVT	EVT-World-War-II
