sl-17
Donald Trump	Donald Trump	PER	PER-Donald-Trump
Donaldu Trumpu	Donald Trump	PER	PER-Donald-Trump
Franc Trček	Franc Trček	PER	PER-Franc-Trček
Janez Janša	Janez Janša	PER	PER-Janez-Janša
Janezom Janšo	Janez Janša	PER	PER-Janez-Janša
Janša	Janša	PER	PER-Janez-Janša
Janševo	Janša	PER	PER-Janez-Janša
Janšo	Janša	PER	PER-Janez-Janša
Jaša	Janša	PER	PER-Janez-Janša
Josephu Bidnu	Joseph Biden	PER	PER-Joe-Biden
Jože P. Damijan	Jože P. Damijan	PER	PER-Jože-P.-Damijan
KUL	KUL	ORG	ORG-Constitutional-Arch-Coalition
Koaliciji ustavnega loka	Koalicija ustavnega loka	ORG	ORG-Constitutional-Arch-Coalition
LMŠ	LMŠ	ORG	ORG-List-of-Marjan-Šarec
Levice	Levica	ORG	ORG-The-Left-Slovenia
Ljubljane	Ljubljana	LOC	GPE-Ljubljana
Luka Mesec	Luka Mesec	PER	PER-Luka-Mesec
Marjan Šarec	Marjan Šarec	PER	PER-Marjan-Šarec
Mesec	Mesec	PER	PER-Luka-Mesec
Poljčah	Poljče	LOC	GPE-Poljče
SD	SD	ORG	ORG-Social-Democrats-Slovenia
Trumpa	Trump	PER	PER-Donald-Trump
državnega zbora	državni zbor	ORG	ORG-National-Assembly-of-the-Republic-of-Slovenia
koalicija Demos	koalicija Demos	ORG	ORG-DEMOS-Democratic-Opposition-of-Slovenia
koronavirusa	koronavirus	EVT	EVT-Covid-19
kovid	kovid	EVT	EVT-Covid-19
Šarca	Šarec	PER	PER-Marjan-Šarec
Šarcu	Šarec	PER	PER-Marjan-Šarec
Šarčevo	Šarec	PER	PER-Marjan-Šarec
