sl-124
Amerika	Amerika	LOC	GPE-USA
Bannon	Bannon	PER	PER-Steve-Bannon
Bannona	Bannon	PER	PER-Steve-Bannon
Bele hiše	Bela hiša	LOC	LOC-White-House
Breitbart News	Breitbart News	ORG	ORG-Breitbart-News
Briana Kolfaga	Brian Kolfag	PER	PER-Brian-Kolfag
Connecticuta	Connecticut	LOC	GPE-Connecticut
Fox News	Fox News	PRO	PRO-Fox-News
Goldman Sachs	Goldman Sachs	ORG	ORG-Goldman-Sachs
Guoja Wenguija	Guo Wengui	PER	PER-Guo-Wengui
Josepha Bidna	Joseph Biden	PER	PER-Joe-Biden
Kate Bedingfield	Kate Bedingfield	PER	PER-Kate-Bedingfield
Manhattan	Manhattan	LOC	LOC-Manhattan
Manhattnu	Manhattan	LOC	LOC-Manhattan
Mehika	Mehika	LOC	GPE-Mexico
Mehike	Mehika	LOC	GPE-Mexico
Mehiko	Mehika	LOC	GPE-Mexico
Michaela Wolffa	Michael Wolf	PER	PER-Michael-Wolf
New Yorka	New York	LOC	GPE-New-York
Novi Mehiki	Nova Mehika	LOC	GPE-New-Mexico
Pentagona	Pentagon	ORG	ORG-The-Pentagon
Steve Bannon	Steve Bannon	PER	PER-Steve-Bannon
Teksasu	Teksas	LOC	GPE-Texas
Trump	Trump	PER	PER-Donald-Trump
Trumpove	Trump	PER	PER-Donald-Trump
Trumpovega	Trump	PER	PER-Donald-Trump
Trumpovi	Trump	PER	PER-Donald-Trump
Wall Streeta	Wall Street	LOC	LOC-Wall-Street
ZDA	ZDA	LOC	GPE-USA
demokrati	demokrati	ORG	ORG-Democratic-Party-USA
pravosodno ministrstvo ZDA	pravosodno ministrstvo ZDA	ORG	ORG-US-Department-of-Justice
