sl-171
Afganistana	Afganistan	LOC	GPE-Afghanistan
Afrike	Afrika	LOC	LOC-Africa
Al Kaide	Al Kaida	ORG	ORG-Al-Qaeda
Al Šabab	Al Šabab	ORG	ORG-Al-Shabaab
Al Šababa	Al Šabab	ORG	ORG-Al-Shabaab
Al Šababu	Al Šabab	ORG	ORG-Al-Shabaab
Američanov	Američani	PER	GPE-USA
Beli hiši	Bela hiša	LOC	LOC-White-House
Donald Trump	Donald Trump	PER	PER-Donald-Trump
Iraka	Irak	LOC	GPE-Iraq
Joe Biden	Joe Biden	PER	PER-Joe-Biden
Marka Esperia	Mark Esper	PER	PER-Mark-Esper
Mogadišu	Mogadiš	LOC	GPE-Mogadishu
Pentagon	Pentagon	ORG	ORG-The-Pentagon
Pentagona	Pentagon	ORG	ORG-The-Pentagon
Pentagonu	Pentagon	ORG	ORG-The-Pentagon
Sahela	Sahel	LOC	LOC-Sahel
Somalije	Somalija	LOC	GPE-Somalia
Somaliji	Somalija	LOC	GPE-Somalia
Somalijo	Somalija	LOC	GPE-Somalia
Trump	Trump	PER	PER-Donald-Trump
Trumpovo	Trump	PER	PER-Donald-Trump
ZDA	ZDA	LOC	GPE-USA
ameriškem obrambnem ministrstvu	ameriško obrambno ministrstvo	ORG	ORG-United-States-Department-of-Defense
hotel Safari	hotel Safari	ORG	ORG-Safari-Hotel
vzhodne Afrike	vzhodna Afrika	LOC	LOC-East-Africa
