sl-170
Alexa Padille	Alex Padilla	PER	PER-Alex-Padilla
Američane	Američani	PER	GPE-USA
Arizone	Arizona	LOC	GPE-Arizona
Atlante	Atlanta	LOC	GPE-Atlanta
Baracka Obama	Barack Obama	PER	PER-Barack-Obama
Baracka Obame	Barack Obama	PER	PER-Barack-Obama
Bidna	Biden	PER	PER-Joe-Biden
Bidnu	Biden	PER	PER-Joe-Biden
Claudia Tenney	Claudia Tenney	PER	PER-Claudia-Tenney
David Perdue	David Perdue	PER	PER-David-Perdue
Delawara	Delaware	LOC	GPE-Delaware
Donald Trump	Donald Trump	PER	PER-Donald-Trump
Donalda Trumpa	Donald Trump	PER	PER-Donald-Trump
Georgea W. Busha	George W. Bush	PER	PER-George-Bush-Jr
Georgie	Georgia	LOC	GPE-Georgia-US-state
Georgiji	Georgia	LOC	GPE-Georgia-US-state
Havajih	Havaji	LOC	GPE-Hawaii
Indiane	Indiana	LOC	GPE-Indiana
Iowi	Iowa	LOC	GPE-Iowa
Joeja Bidna	Joe Biden	PER	PER-Joe-Biden
Kalifornija	Kalifornija	LOC	GPE-California
Kelly Loeffler	Kelly Loeffler	PER	PER-Kelly-Loeffler
Koloradu	Kolorado	LOC	GPE-Colorado
Mariannette Miller-Meeks	Mariannette Miller-Meeks	PER	PER-Mariannette-Miller-Meeks
Mo Brooks	Mo Brooks	PER	PER-Mo-Brooks
Nancy Pelosi	Nancy Pelosi	PER	PER-Nancy-Pelosi
New Jerseyu	New Jersey	LOC	GPE-New-Jersey
New Yorku	New York	LOC	GPE-New-York
Trump	Trump	PER	PER-Donald-Trump
Trumpova	Trump	PER	PER-Donald-Trump
Trumpovem	Trump	PER	PER-Donald-Trump
Trumpovi	Trump	PER	PER-Donald-Trump
Trumpovima	Trump	PER	PER-Donald-Trump
Washington	Washington	LOC	GPE-WashingtonDC
ZDA	ZDA	LOC	GPE-USA
ameriški kongres	ameriški kongres	ORG	ORG-United-States-Congress
covida 19	covid 19	EVT	EVT-Covid-19
demokrati	demokrati	ORG	ORG-Democratic-Party-USA
