sl-167
Ameriškega zdravniškega združenja	Ameriško zdravniško združenje	ORG	ORG-American-Medical-Association
Ameriškega združenja bolnišnic	Ameriško združenje bolnišnic	ORG	ORG-American-Hospital-Association
Annie Tomasini	Annie Tomasini	PER	PER-Annie-Tomasini
Bele hiše	Bela hiša	LOC	LOC-White-House
Beli hiši	Bela hiša	LOC	LOC-White-House
Biden	Biden	PER	PER-Joe-Biden
Bidna	Biden	PER	PER-Joe-Biden
Bidnovo	Biden	PER	PER-Joe-Biden
Cedric Richmond	Cedric Richmond	PER	PER-Cedric-Richmond
Chuck Grassley	Chuck Grassley	PER	PER-Chuck-Grassley
Dana Remus	Dana Remus	PER	PER-Dana-Remus
Debbie Dawson Hatmaker	Debbie Dawson Hatmaker	PER	PER-Debbie-Dawson-Hatmaker
Donald Trump	Donald Trump	PER	PER-Donald-Trump
Giuliani	Giuliani	PER	PER-Rudy-Giuliani
Grassley	Grassley	PER	PER-Chuck-Grassley
Iowe	Iowa	LOC	GPE-Iowa
Iranom	Iran	LOC	GPE-Iran
J ulisso Reynoso Pantaleon	Julissa Reynosa Pantaleon	PER	PER-Julissa-Reynosa-Pantaleon
James Madara	James Madara	PER	PER-James-Madara
Jen O'Malley Dillon	Jen O'Malley Dillon	PER	PER-Jennifer-O'Malley-Dillon
Jill Biden	Jill Biden	PER	PER-Jill-Biden
Joe Biden	Joe Biden	PER	PER-Joe-Biden
Julie Chavez Rodriguez	Julie Chavez Rodriguez	PER	PER-Julie-Chavez-Rodriguez
Kamala Harris	Kamala Harris	PER	PER-Kamala-Harris
Louisiane	Louisiana	LOC	GPE-Louisiana
Mike Donilon	Mike Donilon	PER	PER-Mike-Donilon
Mikom Penceom	Mike Pence	PER	PER-Mike-Pence
Moderna	Moderna	ORG	ORG-Moderna
Nancy Pelosi	Nancy Pelosi	PER	PER-Nancy-Pelosi
Pensilvaniji	Pensilvanija	LOC	GPE-Pennsylvania
Pfizer	Pfizer	ORG	ORG-Pfizer
Richard Pollack	Richard Pollack	PER	PER-Richard-Pollack
Rona Klaina	Ron Klain	PER	PER-Ron-Klain
Rudy Giuliani	Rudy Giuliani	PER	PER-Rudy-Giuliani
Steve Richetti	Steve Richetti	PER	PER-Steve-Richetti
Trump	Trump	PER	PER-Donald-Trump
Trumpove	Trump	PER	PER-Donald-Trump
Trumpovi	Trump	PER	PER-Donald-Trump
Trumpovih	Trump	PER	PER-Donald-Trump
Trumpu	Trump	PER	PER-Donald-Trump
Urugvaju	Urugvaj	LOC	GPE-Uruguay
ZDA	ZDA	LOC	GPE-USA
Združenja ameriških medicinskih sester	Združenje ameriških medicinskih sester	ORG	ORG-American-Nurses-Association
koronavirusom	koronavirus	EVT	EVT-Covid-19
koronavirusu	koronavirus	EVT	EVT-Covid-19
novega koronavirusa	novi koronavirus	EVT	EVT-Covid-19
senatnega odbora za obveščevalne dejavnosti	senatni odbor za obveščevalne dejavnosti	ORG	ORG-United-States-Senate-Select-Committee-on-Intelligence
univerze Johnsa Hopkinsa	Univerza Johna Hopkinsa	ORG	ORG-John-Hopkins-University
urada Bele hiše za medvladne zadeve	urad Bele hiše za medvladne zadeve	ORG	ORG-White-House-Office-of-Intergovernmental-Affairs
urada Bele hiše za odnose z javnostmi	urad Bele hiše za odnose z javnostmi	ORG	ORG-US-Office-of-Public-Engagement
zahvalni dan	zahvalni dan	EVT	EVT-Thanksgiving-Day
