sl-182
Afganistanu	Afganistan	LOC	GPE-Afghanistan
Agencije za nacionalno varnost	Agencija za nacionalno varnost	ORG	ORG-National-Security-Agency-NSA-USA
Alejandra Mayorkasa	Alejandro Mayorkas	PER	PER-Alejandro-Mayorkas
Anthonyja Blinkena	Anthony Blinken	PER	PER-Antony-Blinken
Avril Haines	Avril Haines	PER	PER-Avril-Haines
Biden	Biden	PER	PER-Joe-Biden
Bidnovo	Biden	PER	PER-Joe-Biden
Donalda Trumpa	Donald Trump	PER	PER-Donald-Trump
Hillary Clinton	Hillary Clinton	PER	PER-Hillary-Clinton
Iraku	Irak	LOC	GPE-Iraq
Irana	Iran	LOC	GPE-Iran
Izraela	Izrael	LOC	GPE-Israel
Jaka Sullivana	Jake Sullivan	PER	PER-Jake-Sullivan
John Negroponte	John Negroponte	PER	PER-John-Negroponte
Južnemkitajskem morju	južnokitajsko morje	LOC	LOC-South-China-Sea
Kerryjev	Kerry	PER	PER-John-Kerry
Kitajske	Kitajska	LOC	GPE-China
Kubi	Kuba	LOC	GPE-Cuba
Lindo Thomas Greenfield	Linda Thomas Greenfield	PER	PER-Linda-Thomas-Greenfield
Mayorkas	Mayorkas	PER	PER-Alejandro-Mayorkas
Michael Hayden	Michael Hayden	PER	PER-Michael-Hayden
Mitch McConnell	Mitch McConnell	PER	PER-Mitch-McConnell
NSA	NSA	ORG	ORG-National-Security-Agency-NSA-USA
Palestincev	Palestinci	PER	GPE-Palestine
Rusije	Rusija	LOC	GPE-Russia
Tom Ridge	Tom Ridge	PER	PER-Thomas-Joseph-Ridge
Trump	Trump	PER	PER-Donald-Trump
ZDA	ZDA	LOC	GPE-USA
ZN	ZN	ORG	ORG-United-Nations
obveščevalne agencije Cia	obveščevalna agencija Cia	ORG	ORG-CIA-Central-Intelligence-Agency
republikance	republikanci	PER	ORG-Republican-Party-USA
