sl-181
Američani	Američani	PER	GPE-USA
Barackom Obamo	Barack Obama	PER	PER-Barack-Obama
Bele hiše	Bela hiša	LOC	LOC-White-House
Brian Morgenstern	Brian Morgenstern	PER	PER-Brian-Morgenstern
Cohen	Cohen	PER	PER-Michael-Cohen
Cohena	Cohen	PER	PER-Michael-Cohen
Cohenu	Cohen	PER	PER-Michael-Cohen
Danielsovi	Daniels	PER	PER-Stormy-Daniels
Donald mlajši	Donald mlajši	PER	PER-Donald-Trump-Jr.
Donalda Trumpa	Donald Trump	PER	PER-Donald-Trump
Donaldu Trumpu	Donald Trump	PER	PER-Donald-Trump
Eric	Eric	PER	PER-Eric-Trump
Harvardu	Harvard	ORG	ORG-Harvard-University
Hillary Clinton	Hillary Clinton	PER	PER-Hillary-Clinton
Ivanka	Ivanka	PER	PER-Ivanka-Trump
Južne Afrike	Južna Afrika	LOC	GPE-Republic-of-South-Africa
Latinoameričani	Latinoameričani	PER	GPE-Latin-America
Mehičani	Mehičani	PER	GPE-Mexico
Melanii Trump	Melania Trump	PER	PER-Melania-Trump
Michael Cohen	Michael Cohen	PER	PER-Michael-Cohen
Michaela Cohena	Michael Cohen	PER	PER-Michael-Cohen
Miss Universe	Miss Universe	EVT	EVT-Miss-Universe
Moskvi	Moskva	LOC	GPE-Moscow
Nelojalen: Spomini	Nelojalen: Spomini	PRO	PRO-Disloyal:-A-Memoir:-The-True-Story-of-the-Former-Personal-Attorney-to-President-Donald-J.-Trump
Nelsona Mandelo	Nelson Mandela	PER	PER-Nelson-Mandela
Obama	Obama	PER	PER-Barack-Obama
Obamo	Obama	PER	PER-Barack-Obama
Putina	Putin	PER	PER-Vladimir-Putin
Putinu	Putin	PER	PER-Vladimir-Putin
Rusi	Rusi	PER	GPE-Russia
Rusije	Rusije	LOC	GPE-Russia
Stormy Daniels	Stormy Daniels	PER	PER-Stormy-Daniels
Trump	Trump	PER	PER-Donald-Trump
Trumpa	Trump	PER	PER-Donald-Trump
Trumpom	Trump	PER	PER-Donald-Trump
Trumpova	Trump	PER	PER-Donald-Trump
Trumpovega	Trump	PER	PER-Donald-Trump
Trumpovemu	Trump	PER	PER-Donald-Trump
Trumpovi	Trump	PER	PER-Donald-Trump
Trumpu	Trump	PER	PER-Donald-Trump
Vajenec	Vajenec	PRO	PRO-The-Apprentice
Vladimirja Putina	Vladimir Putin	PER	PER-Vladimir-Putin
ZDA	ZDA	LOC	GPE-USA
ameriške volitve leta 2016	ameriške volitve leta 2016	EVT	EVT-2016-United-States-Presidential-Election
koronavirusa	koronavirus	EVT	EVT-Covid-19
