sl-208
Ala Gora	Al Gore	PER	PER-Al-Gore
Alom Gorom	Al Gore	PER	PER-Al-Gore
Amerike	Amerika	LOC	GPE-USA
Američane	Američani	PER	GPE-USA
Austinu	Austin	LOC	GPE-Austin
Biden	Biden	PER	PER-Joe-Biden
Bush	Bush	PER	PER-George-Bush-Jr
Busha	Bush	PER	PER-George-Bush-Jr
Bushu	Bush	PER	PER-George-Bush-Jr
Clintonovim	Clintonov	PER	PER-Bill-Clinton
Donaldom Trumpom	Donald Trump	PER	PER-Donald-Trump
Floridi	Florida	LOC	GPE-Florida
George Bush	George Bush	PER	PER-George-Bush-Jr
Georgom Bushem II	George Bush II	PER	PER-George-Bush-Jr
Gora	Gore	PER	PER-Al-Gore
Gore	Gore	PER	PER-Al-Gore
Hillary Clinton	Hillary Clinton	PER	PER-Hillary-Clinton
Josephom Bidnom	Joseph Biden	PER	PER-Joe-Biden
Ljubljani	Ljubljana	LOC	GPE-Ljubljana
Republikanci	Republikanci	PER	ORG-Republican-Party-USA
Teksasa	Teksas	LOC	GPE-Texas
Teksasu	Teksas	LOC	GPE-Texas
Trump	Trump	PER	PER-Donald-Trump
Združenih državah Amerike	Združene države Amerike	LOC	GPE-USA
republikancev	republikanci	PER	ORG-Republican-Party-USA
zahodni hemisferi	zahodna hemisfera	LOC	LOC-Western-Hemisphere
