sl-101
Arizoni	Arizona	LOC	GPE-Arizona
Belo hišo	Bela hiša	LOC	LOC-White-House
Biden	Biden	PER	PER-Joe-Biden
Donald Trump	Donald Trump	PER	PER-Donald-Trump
FBI	FBI	ORG	ORG-FBI-Federal-Bureau-of-Investigation
Fox News	Fox News	PRO	PRO-Fox-News
Fox	Fox	PRO	PRO-Fox-News
Joe Biden	Joe Biden	PER	PER-Joe-Biden
Joeja Bidna	Joe Biden	PER	PER-Joe-Biden
Joshua Roberts	Joshua Roberts	PER	PER-Joshua-Roberts
Ken Star	Ken Star	PER	PER-Ken-Star
Kevin O'Connor	Kevin O'Connor	PER	PER-Kevin-O'Connor
Mario Bartiromo	Mario Bartiromo	PER	PER-Maria-Bartiromo
NBC	NBC	PRO	PRO-National-Broadcasting-Company
Reuters	Reuters	ORG	ORG-Reuters
Trump	Trump	PER	PER-Donald-Trump
Trumpov	Trump	PER	PER-Donald-Trump
Trumpove	Trump	PER	PER-Donald-Trump
ZDA	ZDA	LOC	GPE-USA
