sl-116
Adams	Adams	PER	PER-John-Adams
Adamsova	Adams	PER	PER-John-Adams
Andrew Jackson	Andrew Jackson	PER	PER-Andrew-Jackson
Avstraliji	Avstralija	LOC	GPE-Australia
Benjamin Harrison	Benjamin Harrison	PER	PER-Benjamin-Harrison
Benjaminu Harrisonu	Benjamin Harrison	PER	PER-Benjamin-Harrison
Billa Clintona	Bill Clinton	PER	PER-Bill-Clinton
Britanci	Britanci	PER	GPE-Great-Britain
Buffala	Buffalo	LOC	LOC-Buffalo
Bush	Bush	PER	PER-George-Bush-Sr
Bushu	Bush	PER	PER-George-Bush-Sr
Carter	Carter	PER	PER-Jimmy-Carter
Cleveland	Cleveland	PER	PER-Grover-Cleveland
Clevelandu	Cleveland	PER	PER-Grover-Cleveland
Clinton	Clinton	PER	PER-Bill-Clinton
Deklaracije neodvisnosti	Deklaracije neodvisnosti	PRO	PRO-Declaration-of-Independance
Demokratske stranke	Demokratska stranka	ORG	ORG-Democratic-Party-USA
Edwardom Kennedyjem	Edward Kennedy	PER	PER-Edward-Kennedy
Ford	Ford	PER	PER-Gerald-Ford
Franciji	Francija	LOC	GPE-France
Franklinu Rooseveltu	Franklin Roosevelt	PER	PER-Franklin-Roosevelt
George H. W. Bush	George H. W. Bush	PER	PER-George-Bush-Sr
Georgie	Georgia	LOC	GPE-Georgia-US-state
Gerald Ford	Gerald Ford	PER	PER-Gerald-Ford
Grover Cleveland	Grover Cleveland	PER	PER-Grover-Cleveland
Groverja Clevelanda	Grover Cleveland	PER	PER-Grover-Cleveland
Harrisona	Harrison	PER	PER-Benjamin-Harrison
Harrisonova	Harrison	PER	PER-Benjamin-Harrison
Harrisonovih	Harrison	PER	PER-Benjamin-Harrison
Herbert Hoover	Herbert Hoover	PER	PER-Herbert-Hoover
Hoover	Hoover	PER	PER-Herbert-Hoover
Hooverji	Hooverji	PER	PER-Herbert-Hoover
Indiane	Indiana	LOC	GPE-Indiana
Iowe	Iowa	LOC	GPE-Iowa
Iranom	Iran	LOC	GPE-Iran
Jacksonov	Jackson	PER	PER-Andrew-Jackson
Jacksonove	Jackson	PER	PER-Andrew-Jackson
Jamesa Blaina	James Blain	PER	PER-James-Blaine
Jamesa Polka	James Polk	PER	PER-James-K.-Polk
Jasona Weaverja	Jason Weaver	PER	PER-Jason-Weaver
Jeffersona	Jefferson	PER	PER-Thomas-Jefferson
Jimmy Carter	Jimmy Carter	PER	PER-Jimmy-Carter
John Adams	John Adams	PER	PER-John-Adams
John Quincy Adams	John Quincy Adams	PER	PER-John-Quincy-Adams
Johna Adamsa	John Adams	PER	PER-John-Adams
Kalifornije	Kalifornija	LOC	GPE-California
Kip svobode	Kip svobode	PRO	PRO-Statue-of-liberty
Kitajski	Kitajska	LOC	GPE-China
Martin Van Buren	Martin Van Buren	PER	PER-Martin-Van-Buren
Michaela Dukakisa	Michael Dukakis	PER	PER-Michael-Dukakis
New Yorka	New York	LOC	GPE-New-York
Nixona	Nixon	PER	PER-Richard-Nixon
Nobelova nagrada za mir	Nobelova nagrada za mir	PRO	PRO-Nobel-Prize
Ohia	Ohio	LOC	GPE-Ohio
Ohiu	Ohio	LOC	GPE-Ohio
Omahi	Omaha	LOC	GPE-Omaha
Quincy Adams	Quincy Adams	PER	PER-John-Quincy-Adams
Republikanci	Republikanci	ORG	ORG-Republican-Party-USA
Richard Nixon	Richard Nixon	PER	PER-Richard-Nixon
Ronald Reagan	Ronald Reagan	PER	PER-Ronald-Reagan
Ronalda Reagana	Ronald Reagan	PER	PER-Ronald-Reagan
Ross Perot	Ross Perot	PER	PER-Ross-Perot
Sovjetske zveze	Sovjetska zveza	LOC	GPE-Soviet-Union-USSR
Sovjetsko zvezo	Sovjetska zveza	LOC	GPE-Soviet-Union-USSR
Stanforda	Stanford	ORG	ORG-Stanford-University
Taft	Taft	PER	PER-William-Howard-Taft
Theodore Roosevelt	Theodore Roosevelt	PER	PER-Theodore-Roosevelt
Thomas Jefferson	Thomas Jefferson	PER	PER-Thomas-Jefferson
Trumpovih	Trump	PER	PER-Donald-Trump
Van Buren	Van Buren	PER	PER-Martin-Van-Buren
William Harrison	William Harrison	PER	PER-William-Harrison
William Howard Taft	William Howard Taft	PER	PER-William-Howard-Taft
Williama Bryana	William Bryan	PER	PER-William-Bryan
ZDA	ZDA	LOC	GPE-USA
afere Watergate	afera Watergate	EVT	EVT-Watergate-Scandal
ameriškega vrhovnega sodišča	ameriško vrhovno sodišče	ORG	ORG-Supreme-Court-of-the-United-States
demokrati	demokrati	ORG	ORG-Democratic-Party-USA
republikancev	republikanci	ORG	ORG-Republican-Party-USA
republikanci	republikanci	ORG	ORG-Republican-Party-USA
zalivsko vojno	zalivska vojno	EVT	EVT-Gulf-War
