sl-194
Američane	Američani	PER	GPE-USA
Američani	Američani	PER	GPE-USA
Bele hiše	Bela hiša	LOC	LOC-White-House
Bennie Thompson	Bennie Thompson	PER	PER-Bennie-Thompson
Biden	Biden	PER	PER-Joe-Biden
Bidna	Biden	PER	PER-Joe-Biden
Bidnove	Biden	PER	PER-Joe-Biden
Brad Raffensperger	Brad Raffensperger	PER	PER-Brad-Raffensperger
Chris Krebs	Chris Krebs	PER	PER-Chris-Krebs
Chrisa Krebsa	Chris Krebs	PER	PER-Chris-Krebs
Donald Trump	Donald Trump	PER	PER-Donald-Trump
Georgia	Georgia	LOC	GPE-Georgia-US-state
Georgii	Georgia	LOC	GPE-Georgia-US-state
Georgio	Georgia	LOC	GPE-Georgia-US-state
Graham	Graham	PER	PER-Lindsey-Graham
Joeja Bidna	Joe Biden	PER	PER-Joe-Biden
Južne Karoline	Južna Karolina	LOC	GPE-South-Carolina-US-State
Krebs	Krebs	PER	PER-Christopher-Krebs
Lindseyja Grahama	Lindsey Graham	PER	PER-Lindsey-Graham
Marka Esperja	Mark Esper	PER	PER-Mark-Esper
Nadzor nad govoricami	Nadzor nad govoricami	PRO	PRO-Rumor-control
Pensilvaniji	Pensilvanija	LOC	GPE-Pennsylvania
Pentagona	Pentagon	ORG	ORG-The-Pentagon
Philadelphie	Philadelphia	LOC	GPE-Philadelphia
Raffensperger	Raffensperger	PER	PER-Brad-Raffensperger
Trump	Trump	PER	PER-Donald-Trump
Trumpovi	Trump	PER	PER-Donald-Trump
Trumpovih	Trump	PER	PER-Donald-Trump
Trumpovo	Trump	PER	PER-Donald-Trump
Washington Post	Washington Post	PRO	PRO-Washington-Post
ZDA	ZDA	LOC	GPE-USA
agencije za kibernetsko varnost in infrastrukturo	agencija za kibernetsko varnost in infrastrukturo	ORG	ORG-Cybersecurity-and-Infrastructure-Security-Agency-(CISA)
demokratske stranke	demokratska stranka	ORG	ORG-Democratic-Party-USA
ministrstvu za domovinsko varnost	ministrstvo za domovinsko varnost	ORG	ORG-United-States-Secretary-of-Homeland-Security
odbora za domovinsko varnost	odbor za domovinsko varnost	ORG	ORG-United-States-Secretary-of-Homeland-Security
predstavniškem domu kongresa	predstavniški dom kongresa	ORG	ORG-House-of-Representatives(USA)
republikancem	republikanci	ORG	ORG-Republican-Party-USA
republikanske	republikanski	ORG	ORG-Republican-Party-USA
twitterja	twitter	PRO	PRO-Twitter
