sl-135
Američani	Američani	PER	GPE-USA
Američanov	Američani	PER	GPE-USA
Amy Coney Barrett	Amy Coney Barrett	PER	PER-Amy-Coney-Barrett
Arizoni	Arizona	LOC	GPE-Arizona
Barack Obama	Barack Obama	PER	PER-Barack-Obama
Beli hiši	Bela hiša	LOC	LOC-White-House
Belo hišo	Bela hiša	LOC	LOC-White-House
Biden	Biden	PER	PER-Joe-Biden
Bidna	Biden	PER	PER-Joe-Biden
Bidnu	Biden	PER	PER-Joe-Biden
Cala Cunninghama	Cal Cunningham	PER	PER-Cal-Cunningham
Clintonovo	Clinton	PER	PER-Hillary-Clinton
Delawara	Delaware	LOC	GPE-Delaware
Demokrate	demokrati	ORG	ORG-Democratic-Party-USA
Donald Trump	Donald Trump	PER	PER-Donald-Trump
Floridi	Florida	LOC	GPE-Florida
Georgii	Georgia	LOC	GPE-Georgia-US-state
Grand Rapidsu	Grand Rapids	LOC	GPE-Grand-Rapids
Hillary Clinton	Hillary Clinton	PER	PER-Hillary-Clinton
Iowi	Iowa	LOC	GPE-Iowa
Joe Biden	Joe Biden	PER	PER-Joe-Biden
Joni Ernst	Joni Ernst	PER	PER-Joni-Ernst
Južni Karolini	Južna Karolina	LOC	GPE-South-Carolina-US-State
Kamala Harris	Kamala Harris	PER	PER-Kamala-Harris
Latinske Amerike	Latinska Amerika	LOC	LOC-Latin-America
Lindsey Graham	Lindsey Graham	PER	PER-Lindsey-Graham
Mainu	Maine	LOC	GPE-Maine
Mark Kelly	Mark Kelly	PER	PER-Mark-Kelly
Marthe McSally	Martha McSally	PER	PER-Martha-McSally
Michiganu	Michigan	LOC	GPE-Michigan
Minnesoti	Minnesota	LOC	GPE-Minnesota
Montani	Montana	LOC	GPE-Montana-US-State
New York Timesa	New York Times	PRO	PRO-The-New-York-Times
Ohiu	Ohio	LOC	GPE-Ohio
Pensilvaniji	Pensilvanija	LOC	GPE-Pennsylvania
RealClearPolitics	RealClearPolitics	ORG	ORG-RealClearPolitics
Severni Karolini	Severna Karolina	LOC	GPE-North-Carolina-US-State
Susan Collins	Susan Collins	PER	PER-Susan-Collins
Teksasu	Teksas	LOC	GPE-Texas
Thom Tillis	Thom Tillis	PER	PER-Thom-Tills
Trump	Trump	PER	PER-Donald-Trump
Trumpa	Trump	PER	PER-Donald-Trump
Trumpov	Trump	PER	PER-Donald-Trump
Wilmingtonu	Wilmington	LOC	GPE-Wilmington
Wisconsinu	Wisconsin	LOC	GPE-Wisconsin
Združenih državah	Združene države	LOC	GPE-USA
demokrate	demokrati	PER	ORG-Democratic-Party-USA
demokrati	demokrati	ORG	ORG-Democratic-Party-USA
demokratih	demokrati	ORG	ORG-Democratic-Party-USA
demokratov	demokrati	ORG	ORG-Democratic-Party-USA
republikancev	republikanci	ORG	ORG-Republican-Party-USA
republikanci	republikanci	ORG	ORG-Republican-Party-USA
