sl-218
Ameriki	Amerika	LOC	GPE-USA
Ameri훾anih	Ameri훾ani	PER	GPE-USA
Ameri훾anom	Ameri훾ani	PER	GPE-USA
Antidefamacijske lige	Antidefamacijska liga	ORG	ORG-Anti-Defamation-League
Biden	Biden	PER	PER-Joe-Biden
Bidna	Biden	PER	PER-Joe-Biden
CBS	CBS	PRO	PRO-CBS-TV
Chris Wallace	Chris Wallace	PER	PER-Chris-Wallace
Chrisa Wallaca	Chris Wallace	PER	PER-Chris-Wallace
Donald Trump	Donald Trump	PER	PER-Donald-Trump
Enrique Tarrio	Enrique Tarrio	PER	PER-Enrique-Tarrio
Fox News	Fox News	PRO	PRO-Fox-News
Jason Miller	Jason Miller	PER	PER-Jason-Miller
Jonathan Greenblatt	Jonathan Greenblatt	PER	PER-Jonathan-Greenblatt
Josepha Bidna	Joseph Biden	PER	PER-Joe-Biden
Mike Hahn	Mike Hahn	PER	PER-Mike-Hahn
Ohiu	Ohio	LOC	GPE-Ohio
Ponosni fantje	Ponosni fantje	ORG	ORG-Proud-Boys
Ponosnih fantov	Ponosni fantje	ORG	ORG-Proud-Boys
Trump	Trump	PER	PER-Donald-Trump
Trumpov	Trumpov	PER	PER-Donald-Trump
Trumpova	Trump	PER	PER-Donald-Trump
Trumpove	Trump	PER	PER-Donald-Trump
Trumpovo	Trump	PER	PER-Donald-Trump
Trumpu	Trump	PER	PER-Donald-Trump
Turmp	Trump	PER	PER-Donald-Trump
Wallaca	Wallace	PER	PER-Chris-Wallace
Wallace	Wallace	PER	PER-Chris-Wallace
ZDA	ZDA	LOC	GPE-USA
