129
Andrej Babiš	Andrej Babiš	PER	PER-Andrej-Babis
Fakulty vojenského zdravotnictví na Univerzitě obrany	Fakulta vojenského zdravotnictví na Univerzitě obrany	ORG	ORG-Fakulta-vojenskeho-zdravotnictvi-na-univerzite-obrany
Hegerovi	Heger	PER	PER-Leos-Heger
Hradem	Hrad	LOC	LOC-Prague-Castle
Královéhradeckém kraji	Královéhradecký kraj	LOC	GPE-Hradec-Kralove-region
Krétu	Kréta	LOC	LOC-Crete
Leoše Hegera	Leoš Heger	PER	PER-Leos-Heger
Praze	Praha	LOC	GPE-Prague
Prymula	Prymula	PER	PER-Roman-Prymula
Prymulu	Prymula	PER	PER-Roman-Prymula
Roman Prymula	Roman Prymula	PER	PER-Roman-Prymula
Romana Prymuly	Roman Prymula	PER	PER-Roman-Prymula
Romanu Prymulovi	Roman Prymula	PER	PER-Roman-Prymula
SPOZ	SPOZ	ORG	ORG-SPOZ-Czech-political-party
TOP 09	TOP 09	ORG	ORG-TOP-09-political-party-CZ
Vojenské lékařské akademie	Vojenská lékařská akademie	ORG	ORG-Vojenska-lekarska-akademie
covid	covid	EVT	EVT-Covid-19
koronavirem	koronavirus	EVT	EVT-Covid-19
koronavirus	koronavirus	EVT	EVT-Covid-19
prasečí chřipky	prasečí chřipka	EVT	EVT-Swine-Influenza
Ústřední krizový štáb	Ústřední krizový štáb	ORG	ORG-Ustredni-krizovy-stab
Česko	Česko	LOC	GPE-Czech-Republic
Česku	Česko	LOC	GPE-Czech-Republic
Čínou	Čína	LOC	GPE-China
