75
CEPI	CEPI	ORG	ORG-Coalition-for-Epidemic-Preparedness-Innovations
CNBC	CNBC	PRO	PRO-CNBC
Celgene	Celgene	ORG	ORG-Celgene
Forbes	Forbes	PRO	PRO-Forbes
Foundation Medicine	Foundation Medicine	ORG	ORG-Foundation-Medicine
GAVI	GAVI	ORG	ORG-Gavi
Gates	Gates	PER	PER-Bill-Gates
Gatese	Gates	PER	PER-Bill-Gates
Gatesem	Gates	PER	PER-Bill-Gates
Gatesova	Gates	PER	PER-Bill-Gates
Gatesovo	Gates	PER	PER-Bill-Gates
Gatesovy	Gates	PER	PER-Bill-Gates
Genentech	Genentech	ORG	ORG-Genetech
Globální aliance pro vakcinaci a imunizaci	Globální aliance pro vakcinaci a imunizaci	ORG	ORG-Global-Aliance-for-vaccination
Good Club	Good Club	ORG	ORG-Good-Club-Gates
Koronavirus	Koronavirus	EVT	EVT-Covid-19
Massachusettské technologické universitě	Massachusettská technologická universita	ORG	ORG-MIT-Massachusetts-Institue-of-Technology
Milan Šmid	Milan Šmid	PER	PER-Milan-Smid
Novartis	Novartis	ORG	ORG-Novartis
Roche	Roche Holding	ORG	ORG-Roche-Holding
Shiva Ayyadurai	Shiva Ayyadurai	PER	PER-Shiva-Azzadurai
Tamiflu	Tamiflu	PRO	PRO-Tamfilu-Oseltamivir
Vojtěch	Vojtěch	PER	PER-Adam-Vojtěch
WHO	WHO	ORG	ORG-World-Health-Organization
fond Billa a Melindy Gatesových	fond Billa a Melindy Gatesových	ORG	ORG-Bill-and-Melinda-Gates-fund
koronaviru	koronavirus	EVT	EVT-Covid-19
koronavirus	koronavirus	EVT	EVT-Covid-19
ČR	ČR	LOC	GPE-Czech-Republic
Šiva	Šiva	PER	PER-Shiva-Azzadurai
