21
ARM	ARM	ORG	ORG-The-Materials-Reserves-Agency-Poland
Anna Cieślak	Anna Cieślak	PER	PER-Anna-Cieślak
COVID-19	COVID-19	EVT	EVT-Covid-19
Edward Miszczak	Edward Miszczak	PER	PER-Edward-Miszczak
Edwarda Miszczaka	Edward Miszczak	PER	PER-Edward-Miszczak
Krystyna Janda	Krystyna Janda	PER	PER-Krystyna-Janda
Krzysztof Materna	Krzysztof Materna	PER	PER-Krzysztof-Materna
Leszek Miller	Leszek Miller	PER	PER-Leszek-Miller
Maria Seweryn	Maria Seweryn	PER	PER-Maria-Seweryn
Mariusz Walter	Mariusz Walter	PER	PER-Mariusz-Walter
NFZ	NFZ	ORG	ORG-National-Health-Fund-Poland
SLD	SLD	ORG	ORG-Democratic-Left-Alliance-Poland
TVN	TVN	PRO	PRO-TVN
WUM	WUM	ORG	ORG-Warsaw-Medical-University
Warszawskim Uniwersytecie Medycznym	Warszawski Uniwersytet Medyczny	ORG	ORG-Warsaw-Medical-University
Warszawskim Uniwersytetem Medycznym	Warszawski Uniwersytet Medyczny	ORG	ORG-Warsaw-Medical-University
Wiktor Zborowski	Wiktor Zborowski	PER	PER-Wiktor-Zborowski
koronawirusa	koronawirus	EVT	EVT-Covid-19
wpolityce.pl	wpolityce.pl	PRO	PRO-wPolityce.pl
