148
Adam Niedzielski	Adam Niedzielski	PER	PER-Adam-Niedzielski
BioNTech	BioNTech	ORG	ORG-BioNTech
COVID-19	COVID-19	EVT	EVT-Covid-19
Comirnaty	Comirnaty	ORG	ORG-Comirnaty
Dworczyk	Dworczyk	PER	PER-Michał-Dworczyk
KPRM	KPRM	ORG	ORG-Office-of-the-Prime-Minister-Poland
Kancelarii Prezesa Rady Ministrów	Kancelaria Prezesa Rady Ministrów	ORG	ORG-Office-of-the-Prime-Minister-Poland
Michał Dworczyk	Michał Dworczyk	PER	PER-Michał-Dworczyk
Ministerstwa Zdrowia	Ministerstwo Zdrowia	ORG	ORG-Ministry-of-Health-Poland
NFZ	NFZ	ORG	ORG-National-Health-Fund-Poland
Naczelna Rada Lekarska	Naczelna Rada Lekarska	ORG	ORG-Naczelna-Rada-Lekarska-Poland
Narodowym Programem Szczepień	Narodowy Programem Szczepień	PRO	PRO-Narodowy-Proram-Szczepień-Poland
Niedzielski	Niedzielski	PER	PER-Adam-Niedzielski
Pfizer & BioNTech	Pfizer & BioNTech	ORG	ORG-Pfizer-BioNTech
Pfizer	Pfizer	ORG	ORG-Pfizer
Pfizera	Pfizer	ORG	ORG-Pfizer
Polaków	Polacy	PER	GPE-Poland
Polski	Polska	LOC	GPE-Poland
Warszawskiego Uniwersytetu Medycznego	Warszawski Uniwersytet Medyczny	ORG	ORG-Warsaw-Medical-University
Warszawskim Uniwersytetem Medycznym	Warszawski Uniwersytet Medyczny	ORG	ORG-Warsaw-Medical-University
koronawirusa	koronawirus	EVT	EVT-Covid-19
Światowa Organizacja Zdrowia	Światowa Organizacja Zdrowia	ORG	ORG-World-Health-Organization
