218
Adam Niedzielski	Adam Niedzielski	PER	PER-Adam-Niedzielski
Agnieszkę Duczmal	Agnieszka Duczmal	PER	PER-Agnieszka-Duczmal
Andrzej Seweryn	Andrzej Seweryn	PER	PER-Andrzej-Seweryn
Andrzeja Wituskiego	Andrzej Wituski	PER	PER-Andrzej-Wituski
COVID-19	COVID-19	EVT	EVT-Covid-19
Facebooku	Facebook	PRO	PRO-Facebook
Jacek Jaśkowiak	Jacek Jaśkowiak	PER	PER-Jacek-Jaśkowiak
Jaśkowiak	Jaśkowiak	PER	PER-Jacek-Jaśkowiak
KPRM	KPRM	ORG	ORG-Office-of-the-Prime-Minister-Poland
Koronawirus	koronawirus	EVT	EVT-Covid-19
Krystyna Janda	Krystyna Janda	PER	PER-Krystyna-Janda
Magda Umer	Magda Umer	PER	PER-Magda-Umer
Maria Seweryn	Maria Seweryn	PER	PER-Maria-Seweryn
Michał Dworczyk	Michał Dworczyk	PER	PER-Michał-Dworczyk
Polsce	Polska	LOC	GPE-Poland
Poznania	Poznań	LOC	GPE-Poznań
Wiktor Zborowski	Wiktor Zborowski	PER	PER-Wiktor-Zborowski
facebook	facebook	PRO	PRO-Facebook
koronawirusowi	koronawirus	EVT	EVT-Covid-19
