10
Alasce	Alaska	LOC	GPE-Alaska
Ameryce	Ameryka	LOC	GPE-USA
Arizonie	Arizona	LOC	GPE-Arizona
Białego Domu	Biały Dom	LOC	LOC-White-House
Biden	Biden	PER	PER-Joe-Biden
Bidena	Biden	PER	PER-Joe-Biden
Bidenowi	Biden	PER	PER-Joe-Biden
Demokraci	Demokraci	ORG	ORG-Democratic-Party-USA
Demokratów	Demokraci	ORG	ORG-Democratic-Party-USA
Departamentu Sprawiedliwości	Departament Sprawiedliwości	ORG	ORG-United-States-Department-of-Justice
Donaldowi Trumpowi	Donald Trump	PER	PER-Donald-Trump
Emily Murphy	Emily Murphy	PER	PER-Emily-Murphy
General Services Administration	General Services Administration	ORG	ORG-General-Services-Administration
Georgii	Georgia	LOC	GPE-Georgia-US-state
Joe Biden	Joe Biden	PER	PER-Joe-Biden
Karolinie Północnej	Karolina Północna	LOC	GPE-North-Carolina-US-State
Murphy	Murphy	PER	PER-Emily-Murphy
Nevadzie	Nevada	LOC	GPE-Nevada
Pensylwanii	Pensylwania	LOC	GPE-Pennsylvania
Republikanie	Republikanie	ORG	ORG-Republican-Party-USA
Sąd Najwyższy	Sąd Najwyższy	ORG	ORG-Supreme-Court-of-the-United-States
Trumpa	Trump	PER	PER-Donald-Trump
USA	USA	LOC	GPE-USA
William Barr	William Barr	PER	PER-WIlliam-Barr
republikanie	republikanie	ORG	ORG-Republican-Party-USA
