uk-20243
BBC	BBC	ORG	ORG-BBC-Ltd
Європейська правда	Європейська правда	ORG	PRO-European-Truth
Джо Байдена	Джо Байден	PER	PER-Joe-Biden
Дональд Трамп	Дональд Трамп	PER	PER-Donald-Trump
Дональда Трампа	Дональд Трамп	PER	PER-Donald-Trump
Дональду Трампу	Дональд Трамп	PER	PER-Donald-Trump
Капітолій	Капітолій	LOC	LOC-United-States-Capitol
Конгрес	Конгрес	ORG	ORG-United-States-Congress
Мітч Макконнелл	Мітч Макконнелл	PER	PER-Mitch-McConnell
Палата	Палата	ORG	ORG-United-States-House-of-Representatives
Палати представників	Палата представників	ORG	ORG-United-States-House-of-Representatives
США	США	LOC	GPE-USA
Сенат	Сенат	ORG	ORG-United-States-Senate
Сенату	Сенат	ORG	ORG-United-States-Senate
Сенаті США	Сенат США	ORG	ORG-United-States-Senate
Трамп	Трамп	PER	PER-Donald-Trump
Трампа	Трамп	PER	PER-Donald-Trump
Флориди	Флорида	LOC	GPE-Florida
Чака Шумера	Чак Шумер	PER	PER-Chuck-Schumer
виборах	вибори	EVT	EVT-2020-United-States-Presidential-Election
інавгурацію	інавгурація	EVT	EVT-2020-United-States-presidential-inauguration
