uk-20326
AP	AP	ORG	ORG-AP-The-Associated-Press
DW	DW	ORG	ORG-Deutsche-Welle
Deutsche Welle	Deutsche Welle	ORG	ORG-Deutsche-Welle
Reuters	Reuters	ORG	ORG-Reuters
Айдахо	Айдахо	LOC	GPE-Idaho
Байден	Байден	PER	PER-Joe-Biden
Байдена	Байден	PER	PER-Joe-Biden
Байденом	Байден	PER	PER-Joe-Biden
Байдену	Байден	PER	PER-Joe-Biden
Берні Сандерс	Берні Сандерс	PER	PER-Bernie-Sanders
Берні Сандерса	Берні Сандерс	PER	PER-Bernie-Sanders
Вашингтоні	Вашингтон	LOC	GPE-WashingtonDC
Гілларі Клінтон	Гілларі Клінтон	PER	PER-Hillary-Clinton
Демократичної партії США	Демократична партія США	ORG	ORG-Democratic-Party-USA
Демократичної партії	Демократична партія	ORG	ORG-Democratic-Party-USA
Детройті	Детройт	LOC	GPE-Detroit
Джо Байден	Джо Байден	PER	PER-Joe-Biden
Дональда Трампа	Дональд Трамп	PER	PER-Donald-Trump
Дональду Трампу	Дональд Трамп	PER	PER-Donald-Trump
Корреспондент.net	Корреспондент.net	PRO	PRO-Korrespondent-net
Міссісіпі	Міссісіпі	LOC	GPE-Mississippi
Місурі	Місурі	LOC	GPE-Missouri
Мічіган	Мічіган	LOC	GPE-Michigan
Мічігані	Мічіган	LOC	GPE-Michigan
Північній Дакоті	Північна Дакота	LOC	GPE-North-Dakota
Північіній Дакоті	Північна Дакота	LOC	GPE-North-Dakota
США	США	LOC	GPE-USA
Сандерс	Сандерс	PER	PER-Bernie-Sanders
Сандерса	Сандерс	PER	PER-Bernie-Sanders
Сандерсом	Сандерс	PER	PER-Bernie-Sanders
Українська служба	Українська служба	PRO	ORG-DW-Ukrainian-Service
виборах президента США	вибори президента США	EVT	EVT-2020-United-States-Presidential-Election
виборах	вибори	EVT	EVT-2020-United-States-Presidential-Election
виборів	вибори	EVT	EVT-2020-United-States-Presidential-Election
праймеріз	праймеріз	EVT	EVT-Democratic-Party-USA-primaries
президентських виборах	президентські вибори	EVT	EVT-2020-United-States-Presidential-Election
