075
NOVA	NOVA	PRO	PRO-NOVATV
Алън Лихтман	Алън Лихтман	PER	PER-Allan-Lichtman
Америка	Америка	LOC	GPE-USA
Байдън	Байдън	PER	PER-Joe-Biden
Барак Обама	Барак Обама	PER	PER-Barack-Obama
Белия дом	Белия дом	LOC	LOC-White-House
Вашингтон Поуст	Вашингтон Поуст	PRO	PRO-Washington-Post
Голямата депресия	Голяма депресия	EVT	EVT-Great-Depression
Джаред Къшнер	Джаред Къшнер	PER	PER-Jared-Kushner
Джо Байдън	Джо Байдън	PER	PER-Joe-Biden
Джордж Буш	Джордж Буш	PER	PER-George-Bush-Jr
Доналд Джей Тръмп	Доналд Джей Тръмп	PER	PER-Donald-Trump
Доналд Тръмп	Доналд Тръмп	PER	PER-Donald-Trump
Израел	Израел	LOC	GPE-Israel
Лихтман	Лихтман	PER	PER-Allan-Lichtman
Рейгън	Рейгън	PER	PER-Ronald-Reagan
Републиканците	републиканци	PER	ORG-Republican-Party-USA
Роналд Рейгън	Роналд Рейгън	PER	PER-Ronald-Reagan
САЩ	САЩ	LOC	GPE-USA
Съединените щати	Съединени щати	LOC	GPE-USA
Тръмп	Тръмп	PER	PER-Donald-Trump
Хърбърт Хувър	Хърбърт Хувър	PER	PER-Herbert-Hoover
американци	американци	PER	GPE-USA
американците	американци	PER	GPE-USA
договора със Съветския съюз за ограничаване на въоръженията	договор със Съветския съюз за ограничаване на въоръженията	PRO	PRO-Strategic-Arms-Reduction-Treaty
изборите за президент на САЩ	избори за президент на САЩ	EVT	EVT-2020-United-States-Presidential-Election
президентски избори	президентски избори	EVT	EVT-2020-United-States-Presidential-Election
