ru-79
Джо Байдена	Джо Байдена	PER	PER-Joe-Biden
Мичигане	Мичиган	LOC	GPE-Michigan
Carlos Barria	Carlos Barria	PER	PER-Carlos-Barria
GSA	GSA	ORG	ORG-General-Services-Administration
Reuters	Reuters	ORG	ORG-Reuters
The Partnership for Public Service	The Partnership for Public Service	ORG	ORG-The-Partnership-for-Public-Service
Администрация общих служб	Администрация общих служб	ORG	ORG-General-Services-Administration-USA
Альбертом Гором	Альберт Гор	PER	PER-Al-Gore
Аризоне	Аризона	LOC	GPE-Arizona
Байден	Байден	PER	PER-Joe-Biden
Байдена	Байден	PER	PER-Joe-Biden
Байдену	Байден	PER	PER-Joe-Biden
Барак Обама	Барак Обама	PER	PER-Barack-Obama
Белого дома	Белый дом	ORG	ORG-The-White-House
Билл Клинтон	Билл Клинтон	PER	PER-Bill-Clinton
Буша	Буш	PER	PER-George-Bush-Jr
Бушу	Буш	PER	PER-George-Bush-Jr
Верховный суд	Верховный суд	ORG	ORG-Supreme-Court-of-Pakistan
Гора	Гор	PER	PER-Al-Gore
Джо Байден	Джо Байден	PER	PER-Joe-Biden
Джо Байдену	Джо Байден	PER	PER-Joe-Biden
Джордж Буш-младший	Джордж Буш-младший	PER	PER-George-Bush-Jr
Джордж Буш-старший	Джордж Буш-старший	PER	PER-George-Bush-Sr
Джорджем Бушем-младшим	Джордж Буш-младший	PER	PER-George-Bush-Jr
Джорджии	Джорджия	LOC	GPE-Georgia-US-state
Дональд Трамп	Дональд Трамп	PER	PER-Donald-Trump
Дональд Трамп	Дональд Трамп	PER	PER-Donald-Trump
Дональда Трампа	Дональд Трамп	PER	PER-Donald-Trump
Марк Медоуз	Марк Медоуз	PER	PER-Mark-Meadows
Обама	Обама	PER	PER-Barack-Obama
Обама	Обама	PER	PER-Barack-Obama
Пенсильвании	Пенсильвания	LOC	GPE-Pennsylvania
РБК	РБК	ORG	ORG-RBK-Group
Республиканская партия	Республиканская партия	ORG	ORG-Republican-Party-USA
США	США	LOC	GPE-USA
Северной Каролине	Северная Каролина	LOC	GPE-North-Carolina-US-State
Трамп	Трамп	PER	PER-Donald-Trump
Трампа	Трамп	PER	PER-Donald-Trump
Трампа	Трамп	PER	PER-Donald-Trump
Трампу	Трамп	PER	PER-Donald-Trump
Флорида	Флорида	LOC	GPE-Florida
американские	американские	LOC	GPE-USA
американцев	американцы	PER	GPE-USA
демократа	демократ	ORG	ORG-Democratic-Party-USA
демократов	демократ	ORG	ORG-Democratic-Party-USA
демократом	демократ	ORG	ORG-Democratic-Party-USA
республиканских	республиканский	ORG	ORG-Republican-Party-USA
республиканцем	республиканец	ORG	ORG-Republican-Party-USA
российских	российский	LOC	GPE-Russia
