ru-62
2000 гг	выборы 2000	EVT	EVT-2000-United-States-Presidential-Election
2016 году выборы	выборы 2016	EVT	EVT-2016-United-States-Presidential-Election
22-я поправка к конституции	22-я поправка к конституции	PRO	PRO-Twenty-second-Amendment-to-the-US-Constitution
Айова	Айова	LOC	GPE-Iowa
Айове	Айова	LOC	GPE-Iowa
Альберт Гор	Альберт Гор	PER	PER-Al-Gore
Альберта Гора	Альберт Гор	PER	PER-Al-Gore
Американская	американская	LOC	GPE-USA
Америки	Америка	LOC	GPE-USA
Барак Обама	Барак Обама	PER	PER-Barack-Obama
Барака Обамы	Барак Обама	PER	PER-Barack-Obama
Бараку Обаме	Барак Обама	PER	PER-Barack-Obama
Белого дома	Белый дом	ORG	ORG-The-White-House
Второй мировой войны	Второй мировой войны	EVT	EVT-World-War-II
Выборы 1876	выборы 1876	EVT	EVT-1876-United-States-Presidential-Election
Гровер Кливленд	Гровер Кливленд	PER	PER-Grover-Cleveland
Демократическая партии	Демократическая партия	ORG	ORG-Democratic-Party-USA
Демократической партии	Демократическая партия	ORG	ORG-Democratic-Party-USA
Демократической	Демократическая	ORG	ORG-Democratic-Party-USA
Джеральдин Ферраро	Джеральдин Ферраро	PER	PER-Geraldine-Ferraro
Джон Кеннеди	Джон Кеннеди	PER	PER-John-F-Kennedy
Джон Куинси Адамс	Джон Куинси Адамс	PER	PER-John-Adams
Джон Маккейн	Джон Маккейн	PER	PER-John-McCain
Джон Тайлер	Джон Тайлер	PER	PER-John-Tyler
Джоном Маккейном	Джон Маккейн	PER	PER-John-McCain
Джордж Вашингтон	Джордж Вашингтон	PER	PER-George-Washington
Джорджа Вашингтона	Джордж Вашингтон	PER	PER-George-Washington
Джорджем Вашингтоном	Джордж Вашингтон	PER	PER-George-Washington
Джорджу Бушу	Джордж Буш	PER	PER-George-Bush-Jr
Западной Вирджинии	Западная Вирджиния	LOC	GPE-West-Virginia
Колумбия	Колумбия	LOC	GPE-District-of-Columbia
Конгресс	конгресс	ORG	ORG-United-States-Congress
Конгресса	Конгресс	ORG	ORG-United-States-Congress
Конгрессе	Конгресс	ORG	ORG-United-States-Congress
Мэн	Мэн	LOC	GPE-Maine
Небраска	Небраска	LOC	GPE-Nebraska
Небраске	Небраска	LOC	GPE-Nebraska
Небраски	Небраска	LOC	GPE-Nebraska
Нью-Гемпшире	Нью-Гемпшир	LOC	GPE-New-Hampshire
Нью-Гэмпшир	Нью-Гэмпшир	LOC	GPE-New-Hampshire
Нью-Гэмпшире	Нью-Гэмпшир	LOC	GPE-New-Hampshire
Партии вигов	Партия вигов	ORG	ORG-Whig-Party
Праймериз	праймериз	EVT	EVT-2016-USA-primaries
Прогрессивной партии	Прогрессивная партия	ORG	ORG-Progressive-Party
Республиканская	Республиканская	ORG	ORG-Republican-Party-USA
Республиканской партии	Республиканская партия	ORG	ORG-Republican-Party-USA
Республиканской	Республиканская	ORG	ORG-Republican-Party-USA
Рональд Рейган	Рональд Рейган	PER	PER-Ronald-Reagan
США	США	LOC	GPE-USA
Сара Пейлин	Сара Пейлин	PER	PER-Sarah-Palin
Соединенных Штатов	Соединенные Штаты	LOC	GPE-USA
ТАСС	ТАСС	ORG	ORG-TASS-Agency
Теодор Рузвельт	Теодор Рузвельт	PER	PER-Theodore-Roosevelt
Теодора Рузвельта	Теодор Рузвельт	PER	PER-Theodore-Roosevelt
Томас Джефферсон	Томас Джефферсон	PER	PER-Thomas-Jefferson
Уильяма Гаррисона	Уильям Гаррисон	PER	PER-William-Harrison
Улисса Гранта	Улисс Грант	PER	PER-Hiram-Ulysses-Grant
Уолтером Мондейлом	Уолтер Мондейл	PER	PER-Walter-Mondale
Франклин Рузвельт	Франклин Рузвельт	PER	PER-Franklin-Roosevelt
Хиллари Клинтон	Хиллари Клинтон	PER	PER-Hillary-Clinton
американских	американские	LOC	GPE-USA
американское	американский	LOC	GPE-USA
выборах 2008 г	выборы 2008	EVT	EVT-2008-US-Presidential-Election
демократ	демократ	ORG	ORG-Democratic-Party-USA
демократы	демократ	ORG	ORG-Democratic-Party-USA
избирательной кампании	избирательная кампания 2008	EVT	EVT-2008-US-Election-Campaign
кокусы в 2016 году	кокусы в 2016	EVT	EVT-2016-USA-Caucus
коллегии выборщиков	коллегия выборщиков	ORG	ORG-United-States-Electoral-College
коллегию выборщиков	коллегия выборщиков	ORG	ORG-United-States-Electoral-College
палата представителей	палата представителей	ORG	ORG-United-States-House-of-Representatives
палате представителей	палата представителей	ORG	ORG-United-States-House-of-Representatives
республиканец	республиканец	ORG	ORG-Republican-Party-USA
республиканца	республиканец	ORG	ORG-Republican-Party-USA
республиканцу	республиканец	ORG	ORG-Republican-Party-USA
республиканцы	республиканец	ORG	ORG-Republican-Party-USA
сенат	сенат	ORG	ORG-United-States-Senate
сенате	сенат	ORG	ORG-United-States-Senate
