ru-132
12-ю поправку к Конституции	12-ю поправка к Конституции	PRO	PRO-Twelfth-Amendment-to-the-United-States-Constitution
Chicago Tribune	Chicago Tribune	PRO	PRO-Chicago-Tribune
«Ленты.ру»	«Лента.ру»	PRO	PRO-Lenta-Ru
Аарон Бёрр	Аарон Бёрр	PER	PER-Aaron-Burr-Jr
Авраама Линкольна	Авраам Линкольн	PER	PER-Abraham-Lincoln
Ал Гор	Ал Гор	PER	PER-Al-Gore
Александр Гамильтон	Александр Гамильтон	PER	PER-Alexander-Hamilton
Америка	Америка	LOC	GPE-USA
Американское	Американский	LOC	GPE-USA
Америки	Америка	LOC	GPE-USA
Америку	Америка	LOC	GPE-USA
Байденом	Байден	PER	PER-Joe-Biden
Белом доме	Белый дом	ORG	ORG-The-White-House
Белый дом	Белый дом	ORG	ORG-The-White-House
Берни Сандерс	Берни Сандерс	PER	PER-Bernie-Sanders
Буш	Буш	PER	PER-George-Bush-Jr
Буша	Буш	PER	PER-George-Bush-Jr
Бушу	Буш	PER	PER-George-Bush-Jr
Бёрр	Бёрр	PER	PER-Aaron-Burr-Jr
Бёрра	Бёрр	PER	PER-Aaron-Burr-Jr
Бёрром	Бёрр	PER	PER-Aaron-Burr-Jr
Бёрру	Бёрр	PER	PER-Aaron-Burr-Jr
Верховного суда	Верховный суд	ORG	ORG-Supreme-Court-of-the-United-States
Верховный суд	Верховный суд	ORG	ORG-Supreme-Court-of-the-United-States
Верховный суд	Верховный суд	ORG	ORG-Supreme-Court-of-Pakistan
Верховный суд	Верховный суд	ORG	ORG-Supreme-Court-of-the-United-States
Вирджинии	Вирджиния	LOC	GPE-Virginia
Вудро Вильсон	Вудро Вильсон	PER	PER-Woodrow-Wilson
Гамильтона	Гамильтон	PER	PER-Alexander-Hamilton
Гамильтоном	Гамильтон	PER	PER-Alexander-Hamilton
Гарри Труман	Гарри Труман	PER	PER-Harry-S.-Truman
Гор	Гор	PER	PER-Al-Gore
Гору	Гор	PER	PER-Al-Gore
Гражданская война	Гражданская война	EVT	EVT-USA-Civil-War
Декларации о независимости	Декларация о независимости	PRO	PRO-United-States-Declaration-of-Independence
Демократическая партия	Демократическая партия	ORG	ORG-Democratic-Party-USA
Демократическо-республиканская	Демократическо-республиканская	ORG	ORG-Democratic-Republican-Party-USA
Демократической партии	Демократическая партия	ORG	ORG-Democratic-Party-USA
Демократы	Демократы	ORG	ORG-Democratic-Party-USA
Демократы	Демократы	ORG	ORG-Democratic-Party-USA
Джефферсона	Джефферсон	PER	PER-Thomas-Jefferson
Джефферсона	Джефферсона	PER	PER-Thomas-Jefferson
Джо Байден	Джо Байден	PER	PER-Joe-Biden
Джо Байдена	Джо Байден	PER	PER-Joe-Biden
Джо Байдену	Джо Байден	PER	PER-Joe-Biden
Джордж Буш-младший	Джордж Буш-младший	PER	PER-George-Bush-Jr
Дональд Трамп	Дональд Трамп	PER	PER-Donald-Trump
Дональда Трампа	Дональд Трамп	PER	PER-Donald-Trump
Дьюи	Дьюи	PER	PER-Thomas-E.-Dewey
Кентукки	Кентукки	LOC	GPE-Kentucky
Клинтон	Клинтон	PER	PER-Hillary-Clinton
Конгресс	Конгресс	ORG	ORG-United-States-Congress
Конгресса	Конгресс	ORG	ORG-United-States-Congress
Конгрессе	Конгресс	ORG	ORG-United-States-Congress
Конфедеративные Штаты Америки	Конфедеративные Штаты Америки	LOC	GPE-Confederate-States-of-America
Линкольн	Линкольн	PER	PER-Abraham-Lincoln
Линкольна	Линкольн	PER	PER-Abraham-Lincoln
Нью-Йорка	Нью-Йорк	LOC	GPE-New-York
Прогрессивной партии	Прогрессивная партия	ORG	ORG-Progressive-Party
Ратерфорда Хейза	Ратерфорд Хейз	PER	PER-Rutherford-Hayes
Реконструкцией	Реконструкция	EVT	EVT-The-Reconstruction-era
Республиканская партия	Республиканская партия	ORG	ORG-Republican-Party-USA
Республиканской партии	Республиканская партия	ORG	ORG-Republican-Party-USA
Рузвельт	Рузвельт	PER	PER-Franklin-Roosevelt
Рузвельта	Рузвельт	PER	PER-Franklin-Roosevelt
США	США	LOC	GPE-USA
Соединенных Штатах	Соединенные Штаты	LOC	GPE-USA
Соединенных Штатов	Соединенные Штаты	LOC	GPE-USA
Сэмюэл Тилден	Сэмюэл Тилден	PER	PER-Samuel-Jones-Tilden
Тафт	Тафт	PER	PER-William-Howard-Taft
Теодор Рузвельт	Теодор Рузвельт	PER	PER-Theodore-Roosevelt
Техас	Техас	LOC	GPE-Texas
Тилден	Тилден	PER	PER-Samuel-Jones-Tilden
Томасом Дьюи	Томас Дьюи	PER	PER-Thomas-E.-Dewey
Томасу Джефферсону	Томас Джефферсон	PER	PER-Thomas-Jefferson
Трамп	Трамп	PER	PER-Donald-Trump
Трампа	Трам	PER	PER-Donald-Trump
Трампа	Трамп	PER	PER-Donald-Trump
Трампу	Трамп	PER	PER-Donald-Trump
Труман	Труман	PER	PER-Harry-S.-Truman
Трумана	Труман	PER	PER-Harry-S.-Truman
Уильяму Говарду Тафту	Уильям Говард Тафт	PER	PER-William-Howard-Taft
Федералистская партия	Федералистская партия	ORG	ORG-Federalist-Party-USA
Федералистская	Федералистская	ORG	ORG-Federalist-Party-USA
Флорида	Флорида	LOC	GPE-Florida
Хейз	Хейз	PER	PER-Rutherford-Hayes
Хиллари Клинтон	Хиллари Клинтон	PER	PER-Hillary-Clinton
Эдгар Аллан По	Эдгар Аллан По	PER	PER-Edgar-Allan-Poe
Юг	Юг	ORG	GPE-Southern-States-USA
Юджин Дебс	Юджин Дебс	PER	PER-Eugene-V.-Debs
Южная Каролина	Южная Каролина	LOC	GPE-South-Carolina-US-State
американская	американский	LOC	GPE-USA
американские	американские	LOC	GPE-USA
американский	американский	LOC	GPE-USA
американским	американские	LOC	GPE-USA
американских	американские	LOC	GPE-USA
американского	американский	LOC	GPE-USA
американское	американский	LOC	GPE-USA
американское	американское	LOC	GPE-USA
американской	американский	LOC	GPE-USA
американцев	американцы	PER	GPE-USA
американцы	американцы	PER	GPE-USA
английских	английские	LOC	GPE-Great-Britain
выборах 1800	выборы 1800	EVT	EVT-1800-United-States-Presidential-Election
выборах 1876	выборы 1876	EVT	EVT-1876-United-States-Presidential-Election
выборах 2000	выборы 2000	EVT	EVT-2000-United-States-Presidential-Election
выборов 1876	выборы 1876	EVT	EVT-1876-United-States-Presidential-Election
демократ	демократ	ORG	ORG-Democratic-Party-USA
демократами	демократы	ORG	ORG-Democratic-Party-USA
демократическими	демократические	ORG	ORG-Democratic-Party-USA
демократов	демократы	ORG	ORG-Democratic-Party-USA
демократы	демократ	ORG	ORG-Democratic-Party-USA
коронавируса	коронавирус	EVT	EVT-Covid-19
нижняя палата парламента США	нижняя палата парламента США	ORG	ORG-United-States-House-of-Representatives
палата представителей Конгресса	палата представителей Конгресса	ORG	ORG-United-States-House-of-Representatives
палаты представителей	палаты представителей	ORG	ORG-United-States-House-of-Representatives
республиканец	республиканец	ORG	ORG-Republican-Party-USA
республиканца	республиканец	ORG	ORG-Republican-Party-USA
республиканца	республиканец	ORG	ORG-Republican-Party-USA
республиканцев	республиканцы	ORG	ORG-Republican-Party-USA
республиканцем	республиканец	ORG	ORG-Republican-Party-USA
республиканцы	республиканцы	ORG	ORG-Republican-Party-USA
федералистов	федералисты	ORG	ORG-Federalist-Party-USA
федералисты	федералисты	ORG	ORG-Federalist-Party-USA
