ru-9
ForumDaily New York	ForumDaily New York	PRO	PRO-NewYork.ForumDaily.com
Shutterstock	Shutterstock	PRO	PRO-Shutterstock
Антифа	Антифа	ORG	ORG-Antifa-USA
Антон Сахаров	Антон Сахаров	PER	PER-Anton-Sakharov
Антон	Антон Сахаров	PER	PER-Anton-Sakharov
Антона Сахарова	Антон Сахаров	PER	PER-Anton-Sakharov
Антона	Антон Сахаров	PER	PER-Anton-Sakharov
Антоном Сахаровым	Антон Сахаров	PER	PER-Anton-Sakharov
Антону	Антон Сахаров	PER	PER-Anton-Sakharov
Барака Обамы	Барак Обама	PER	PER-Barack-Obama
Биллом Брайантом	Билл Брайант	PER	PER-Bill-Bryant
Большом Яблоке	Большое Яблоко	LOC	GPE-New-York
Брайанта	Билл Брайнт	PER	PER-Bill-Bryant
Вашингтон	Вашингтон	LOC	GPE-WashingtonDC
Вашингтона	Вашингтон	LOC	GPE-WashingtonDC
Викторию Спартц	Виктория Спартц	PER	PER-Victoria-Spartz
Висконсин	Висконсин	LOC	GPE-Wisconsin
Демократической	Демократическая партия	ORG	ORG-Democratic-Party-USA
Джеем Инсли	Джей Инсли	PER	PER-Jay-Inslee
Джей Инсли	Джей Инсли	PER	PER-Jay-Inslee
Джона Маккейна	Джон Маккейн	PER	PER-John-McCain
Дональд Трамп	Дональд Трамп	PER	PER-Donald-Trump
Дональда Трампа	Дональд Трамп	PER	PER-Donald-Trump
Индиана	Индиана	LOC	GPE-Indiana
Калифорнии	Калифорния	LOC	GPE-California
Нью-Йорка	Нью-Йорк	LOC	GPE-New-York
Республиканская партия	Республиканская партия	ORG	ORG-Republican-Party-USA
Республиканской партии	Республиканская партия	ORG	ORG-Republican-Party-USA
Республиканской	Республиканская партия	ORG	ORG-Republican-Party-USA
России	Россия	LOC	GPE-Russia
СССР	СССР	LOC	GPE-USSR
США	США	LOC	GPE-USA
Сахаров	Антон Сахаров	PER	PER-Anton-Sakharov
Сиэтла	Сиэтл	LOC	GPE-Seattle
Соединенные Штаты	Соединенные Штаты	LOC	GPE-USA
Трамп	Трамп	PER	PER-Donald-Trump
Трампа	Трам	PER	PER-Donald-Trump
Тэд Круз	Тэд Круз	PER	PER-Ted-Cruz
американские	американские	LOC	GPE-USA
американских	американский	LOC	GPE-USA
американской	американская	LOC	GPE-USA
американском	американский	LOC	GPE-USA
выборов Джорджа Буша (2004 год)	выборы Джорджа Буша 2004 год	EVT	EVT-2004-United-States-Presidential-Election
демократом	демократ	PER	ORG-Democratic-Party-USA
демократы	демократ	PER	ORG-Democratic-Party-USA
президентских выборах 2016 года	президентские выборы 2016 года	EVT	EVT-2016-United-States-Presidential-Election
республиканец	республиканец	PER	ORG-Republican-Party-USA
республиканцев	республиканец	ORG	ORG-Republican-Party-USA
республиканцев	республиканец	PER	ORG-Republican-Party-USA
республиканцем	республиканец	PER	ORG-Republican-Party-USA
российский	российский	LOC	GPE-Russia
