ru-54
Колумбийском университете	Колумбийский университет	ORG	ORG-Columbia-University
Alexander Cooley	Alexander Cooley	PER	PER-Alexander-Cooley
Cyberwar: How Russian Hackers and Trolls Helped Elect a President	Cyberwar: How Russian Hackers and Trolls Helped Elect a President	PRO	PRO-Cyberwar:-How-Russian-Hackers-and-Trolls-Helped-Elect-a-President
David Shimer	David Shimer	PER	PER-David-Shimer
Facebook	Facebook	PRO	PRO-Facebook
Joshua Tucker	Joshua Tucker	PER	PER-Joshua-Tucker
Kathleen Hall Jamieson	Kathleen Hall Jamieson	PER	PER-Kathleen-Hall-Jamieson
NYU	NYU	ORG	ORG-New-York-University
RT	RT	PRO	PRO-RT-Russia-Today
Renee DiResta	Renee DiResta	PER	PER-Renee-DiResta
Rigged: America, Russia, and One Hundred Years of Covert Electoral Interference	Rigged: America, Russia, and One Hundred Years of Covert Electoral Interference	PRO	PRO- Rigged:-America,-Russia,-and-One-Hundred-Years-of-Covert-Electoral-Interference
Russia Today	Russia Today	PRO	PRO-RT-Russia-Today
Wikileaks	Wikileaks	ORG	ORG-Wikileaks
Zeve Sanderson	Zeve Sanderson	PER	PER-Zeve-Sanderson
Zoom	Zoom	PRO	PRO-Zoom
«Вашингтон пост»	Вашингтон пост	PRO	PRO-Washington-Post
«Кибервойна: как русские хакеры и тролли помогли выбрать президента»	«Кибервойна: как русские хакеры и тролли помогли выбрать президента»	PRO	PRO-Cyberwar:-How-Russian-Hackers-and-Trolls-Helped-Elect-a-President
«Нью-Йорк таймс»	Нью-Йорк Таймс	PRO	PRO-The-New-York-Times
«Нью-Йоркере»	Нью-Йоркер	PRO	PRO-The-New-Yorker
«Объединение мусульман Америки»	Объединение мусульман Америки	ORG	ORG-United-Muslims-of-America
«Подтасовка: Америка, Россия и сто лет тайного вмешательства в выборы»	«Подтасовка: Америка, Россия и сто лет тайного вмешательства в выборы»	PRO	PRO- Rigged:-America,-Russia,-and-One-Hundred-Years-of-Covert-Electoral-Interference
«Твиттере»	Твиттер	PRO	PRO-Twitter
«кремлеботы»	кремлеботы	ORG	ORG-Internet-Research-Agency
«фабрика пригожинских троллей»	фабрика пригожинских троллей	ORG	ORG-Internet-Research-Agency
«холодной войны»	«холодная война»	EVT	EVT-Cold-War
Агентство интернет-исследований	Aгентство интернет-исследований	ORG	ORG-Internet-Research-Agency
Александер Кули	Александер Кули	PER	PER-Alexander-Cooley
Америки	Америка	LOC	GPE-USA
Америку	Америка	LOC	GPE-USA
Анненберга	Анненберг	PER	PER-Walter-Hubert-Annenberg
Ассоциации американских издателей	Ассоциация американских издателей	ORG	ORG-APA-American-Publishers-Association
ГРУ	ГРУ	ORG	ORG-GRU-(Russian-GU)
Госдепартамент	Госдепартамент	ORG	ORG-Department-of-State-USA
Джеймисон	Джеймисон	PER	PER-Kathleen-Hall-Jamieson
Джо Байдену	Джо Байден	PER	PER-Joe-Biden
Джошуа Такер	Джошуа Такер	PER	PER-Joshua-Tucker
Джулиана Ассанжа	Джулиан Ассанж	PER	PER-Julian-Assange
Дональду Трампу	Дональд Трамп	PER	PER-Donald-Trump
Дэвид Шаймер	Дэвид Шаймер	PER	PER-David-Shimer
Западе	Запад	LOC	LOC-West
Зив Сандерсон	Зив Сандерсон	PER	PER-Zeve-Sanderson
Инстаграм	Инстаграм	PRO	PRO-Instagram
Института Харримана	Институт Харримана	ORG	ORG-The-Harriman-Institute
Институтом Харримана	Институт Харримана	ORG	ORG-The-Harriman-Institute
Италии	Италия	LOC	GPE-Italy
Йельском университете	Йельский университет	ORG	ORG-Yale-University
Коминтерн	Коминтерн	ORG	ORG-Сomintern
Конгресс	Конгресс	ORG	ORG-United-States-Congress
Кремль	Кремль	ORG	ORG-Kremlin
Кремля	Кремль	ORG	ORG-Kremlin
Кули	Кули	PER	PER-Alexander-Cooley
Кэтлин Холл Джеймисон	Кэтлин Холл Джеймисон	PER	PER-Kathleen-Hall-Jamieson
Ленин	Ленин	PER	PER-Lenin
Нью-Йорке	Нью-Йорк	LOC	GPE-New-York
Нью-Йоркский университет	Нью-Йоркский университет	ORG	ORG-New-York-University
Оксфордском университете	Оксфордский университет	ORG	ORG-University-of-Oxford
Пенсильванском университете	Пенсильванский университет	ORG	ORG-University-of-Pennsylvania
Пригожина	Пригожин	PER	PER-Evgeniy-Prigozhin
Путин	Путин	PER	PER-Vladimir-Putin
Рене ДиРеста	Рене ДиРеста	PER	PER-Renee-DiResta
Рене	Рене	PER	PER-Renee-DiResta
России	Россия	LOC	GPE-Russia
Российские	Российский	LOC	GPE-Russia
Российское	российское	LOC	GPE-Russia
Россия	Россия	LOC	GPE-Russia
Русской службы «Голоса Америки»	Русская служба "Голос Америки"	ORG	ORG-Voice-of-America
США	США	LOC	GPE-USA
Сальвадора	Сальвадор	LOC	GPE-El-Salvador
Сербии	Сербия	LOC	GPE-Serbia
Советам	Советы	LOC	GPE-USSR
Советского Союза	Советский Союз	LOC	GPE-USSR
Стэнфордского университета	Стэнфордский университет	ORG	ORG-Stanford-University
Такера	Такер	PER	PER-Joshua-Tucker
Техаса	Техас	LOC	GPE-Texas
Труменом	Трумен	PER	PER-Harry-S.-Truman
Фейсбуке	Фейсбук	PRO	PRO-Facebook
Франции	Франция	LOC	GPE-France
Хиллари Клинтон	Хиллари Клинтон	PER	PER-Hillary-Clinton
Хиллари	Хиллари	PER	PER-Hillary-Clinton
Хьюстоне	Хьюстон	LOC	GPE-Houston
ЦРУ	ЦРУ	ORG	ORG-CIA-Central-Intelligence-Agency
Центра Джордана	Центр Джордана	ORG	ORG-The-Jordan-Center
Центра социальных медиа и политики	Центр социальных медиа и политики	ORG	ORG-Center-of-Social-Media-and-Policy
Центром Джордана	Центр Джордана	ORG	ORG-The-Jordan-Center
Чили	Чили	LOC	GPE-Chile
Шаймер	Шаймер	PER	PER-David-Shimer
Шаймера	Шаймер	PER	PER-David-Shimer
Японии	Япония	LOC	GPE-Japan
выборах 2016 года	выборы 2016 года	EVT	EVT-2016-United-States-Presidential-Election
выборах президента США	выборах президента США	EVT	EVT-2020-United-States-Presidential-Election
выборы 2016 года в США	выборы 2016 в США	EVT	EVT-2016-United-States-Presidential-Election
демократов	демократы	ORG	ORG-Democratic-Party-USA
европейских	европейские	LOC	LOC-Europe
предвыборной кампании 2016 года	предвыборная кампания 2016	EVT	EVT-2016-US-Presidential-Campaign
президентские выборы в США 2016-го	президентские выборы в США 2016	EVT	EVT-2016-United-States-Presidential-Election
президентские выборы в США в 2016 году	президентские выборы в США в 2016	EVT	EVT-2016-United-States-Presidential-Election
президентскую кампанию 2016 года	президентская кампания 2016	EVT	EVT-2016-US-Presidential-Campaign
российская военная разведка	российская военная разведка	ORG	ORG-GRU-(Russian-GU)